11111111111111101111111111111111
10000000000100101001000001010001
10111011110100101001011101010101
10101010010100101001010101110101
10101010010100101001010100000101
10111011110111101111011111110101
10000000000000000000000000000101
10111011111111101111011101110101
10101010000000101001010101010101
10101011111011101111011101110101
10101000001010000000000100000101
10101011101010111101110101110101
10101010101110100101010101010101
10111010100000100101010001010001
10000010111110100101011101011101
11111010000010000101000131000101
11111010000010000101000101000101
10000010111110100101011101011101
10111010100000100101012221010001
10101010101110100101012121010101
10101011101010111101112121110101
10101000001010000000222120000101
10101011111011101111211121110101
10101010000000101001210121010101
10111011111111101111211121110101
10000000000000000000222220000101
10111011110111101111011111110101
10101010010100101001010100000101
10101010010100101001010101110101
10111011110100101001011101010101
10000000000100101001000001010001
11111111111111101111111111111111
