11111111111111101111111111111111
10000000000111101111000001112201
10111011110111101111011101110101
10111011110111101111011101110121
10111011110111101111011100000101
10111011110111101111011111110121
10000000000000000000000000000121
10111011111111101111011101110101
10111011111111101111011101110121
10111011111111101111011101110101
10111000001110000000000100000101
10111011101110111101110101110101
10111011101110100101110101110101
10111011100000100101110001110001
10000011111110100101111101111101
11111011111114100101111131111101
11111011111110100101111101111101
10000011111112100101111101111101
10111011100000100101110001110001
10111011101112100101110101110101
10111011101110111101110101110101
10111000001112000200000100000101
10111011111111101111011101110101
10111011111111101111011101110101
10111011111111101111011101110101
10000000000000020000000000000101
10111011110111101111011111110101
10111011110111101111011100000101
10111011110111101111011101110101
10111011110111101111011101110101
10000000000111101111000001110001
11111111111111101111111111111111
